b,clu,ch,cru,b,b,b,b,b,b,b,b,b,b,b,n
b,cv,m,cv,b,b,b,b,b,b,b,b,b,b,b,n
b,cld,dd,crd,b,b,b,b,b,p,p,p,p,p,b,n
b,s2,p,s2,b,p,p,p,p,p,p,b,p,p,b,n
b,p,p,p,p,p,p,b,b,b,b,b,p,p,b,n
b,b,b,b,b,b,b,b,b,p,p,p,p,p,b,n
b,b,b,b,b,p,p,p,p,p,p,b,b,b,b,n
b,p,p,p,p,p,p,b,b,b,b,b,b,b,b,n
b,p,p,b,b,b,b,b,p,p,p,p,p,p,b,n
b,p,p,b,p,p,p,p,p,p,b,b,p,p,b,n
b,p,p,p,p,p,b,b,b,b,b,b,p,p,b,n
b,b,b,b,b,b,b,b,p,p,p,p,p,p,b,n
b,b,b,b,p,p,p,p,p,p,b,b,b,b,b,n
s,p,p,s,p,p,b,b,b,b,b,b,b,b,b,n
b,b,b,b,b,b,b,b,b,b,b,b,b,b,b,n
