b,clu,ch,cru,b,b,b,b,b,b,b,b,b,b,b,n
b,cv,m,cv,b,n,n,n,b,b,b,b,b,b,b,n
b,cld,dd,crd,b,b,b,b,b,p,p,p,p,p,b,n
b,b,p,b,b,p,p,p,p,p,b,b,b,p,b,n
b,b,p,p,p,p,b,b,b,b,b,b,b,p,b,n
b,b,b,b,b,b,b,b,b,p,p,p,p,p,b,n
b,b,b,b,b,p,p,p,p,p,b,b,b,b,b,n
b,p,p,p,p,p,b,b,b,b,b,b,b,b,b,n
b,p,b,b,b,b,b,b,b,p,p,p,p,p,b,n
b,p,b,b,b,p,p,p,p,p,b,b,b,p,b,n
b,p,p,p,p,p,b,b,b,b,b,b,b,p,b,n
b,b,b,b,b,b,b,b,b,p,p,p,p,p,b,n
s,b,b,b,b,p,p,p,p,p,b,b,b,b,b,n
s,p,p,p,p,p,b,b,b,b,b,b,b,n,s2,n
b,b,b,b,b,b,b,b,b,b,b,b,b,s2,n,n
