b,b,b,b,b,b,b,b,b,b,b,b,b,b,s2,n
s,p,p,p,p,p,p,p,p,p,p,p,p,p,b,n
b,b,b,b,b,b,b,b,b,b,b,b,b,p,b,n
b,p,p,p,p,p,p,p,b,n,n,n,b,p,b,n
b,p,b,b,b,b,b,p,b,n,n,n,b,p,b,n
b,p,b,n,n,n,b,p,b,n,n,n,b,p,b,n
b,p,b,n,n,n,clu,du,cru,n,n,n,b,p,b,n
b,p,b,n,n,n,cv,m,cv,n,n,n,b,p,b,n
b,p,b,n,n,n,cld,dd,crd,n,n,n,b,p,b,n
b,p,b,n,n,n,b,p,b,n,n,n,b,p,b,n
b,p,b,n,n,n,b,p,b,b,b,b,b,p,b,n
b,p,b,n,n,n,b,p,p,p,p,p,p,p,b,n
b,p,b,b,b,b,b,b,b,b,b,b,b,b,b,n
b,p,p,p,p,p,p,p,p,p,p,p,p,p,s,n
s2,b,b,b,b,b,b,b,b,b,b,b,b,b,b,n
