b,b,b,b,b,b,b,b,b,b,b,b,b,b,b,n
b,p,p,p,b,n,n,n,n,n,b,p,p,p,b,n
b,p,b,p,b,n,n,n,n,n,b,p,b,p,b,n
b,p,b,p,b,n,n,n,n,n,b,p,b,p,b,n
b,p,b,p,b,n,n,n,n,n,b,p,b,p,b,n
b,p,b,p,b,n,n,n,n,n,b,p,b,p,b,n
b,p,b,p,b,n,clu,ch,cru,n,b,p,b,p,b,n
b,p,b,p,b,n,cv,m,cv,n,b,p,b,p,b,n
b,p,b,p,b,n,cld,dd,crd,n,b,p,b,p,b,n
b,p,b,p,b,n,b,p,b,n,b,p,b,p,b,n
b,p,b,p,b,n,b,p,b,n,b,p,b,p,b,n
b,p,b,p,b,b,b,p,b,b,b,p,b,p,b,n
b,p,b,p,p,p,p,p,p,p,p,p,b,p,b,n
b,p,b,b,b,b,b,b,b,b,b,b,b,p,b,n
b,s,b,b,b,b,b,s3,b,b,b,b,b,s,b,n
