b,b,b,b,b,b,b,b,b,b,b,b,b,b,b,n
b,p,p,p,b,n,clu,ch,cru,n,b,p,p,p,b,n
b,p,p,p,b,n,cv,m,cv,n,b,p,p,p,b,n
b,p,b,p,b,n,cld,dd,crd,n,b,p,b,p,b,n
b,p,b,p,b,n,b,p,b,n,b,p,b,p,b,n
b,p,b,p,b,n,b,p,b,n,b,p,b,p,b,n
b,p,b,p,b,n,b,p,b,n,b,p,b,p,b,n
b,p,b,p,b,n,b,p,b,n,b,p,b,p,b,n
b,p,b,p,b,n,b,p,b,n,b,p,b,p,b,n
b,p,b,p,b,n,b,p,b,n,b,p,b,p,b,n
b,p,b,p,b,n,b,p,b,n,b,p,b,p,b,n
b,p,b,p,b,b,b,p,b,b,b,p,b,p,b,n
b,p,b,p,p,p,p,p,p,p,p,p,b,p,b,n
b,p,b,b,b,b,b,b,b,b,b,b,b,p,b,n
b,s,b,b,b,b,s2,p,s2,b,b,b,b,s,b,n
